11111111111
1P0000000E1
11111101101
1010C101011
10000100101
10001110001
10000100001
10100000101
1C110001101
100000C0001
11111111111