11111111111111
1C11000C000011
10000011110P11
1C00011E00C011
11111111111111