11111111111111111111111111
11111111111111111111111111
1111111E011111111111111111
11P0111000000C000000000C11
11001111111111111111110011
11111111111111111111110011
11001111111111111111110011
11C01100110011000000110011
11001100110011111100110C11
11001100000011000000110011
11001111110011001111110011
11001111110011000000110011
11C01111111111111111110011
11001111111111111111110011
11001111111111111111110011
11000000C0000000000000C011
11111111111111111111111111
11111111111111111111111111
11111111111111111111111111