1111111111111111111111111111
1E0001111111111110000C0000C1
11100100000001C0101001010111
1C10010111111111101001010101
100000000C00C0000000000000P1
1111111111111111111111111111