11111111111111111111111111111
1C0000C00000C000C000000C00001
10011111111111111111111111001
1C0000C00C000000000000000C1C1
111111111111100011C00011110C1
1C0000000000000011000000C1101
11111111010111111111110001001
100000C10C00000C1110C00001101
10001111111111111110000011001
1C000000000000001100001C010C1
1111111111111100000C001111001
1P000000000000C00000001111E01
11111111111111111111111111111